11111111111111111
100000000002000p1
12121010101210101
10020202220222221
10101212101010101
10020202020202021
10101210101010101
10202200002200001
10101210101210101
10022200000000001
10101010101210101
10000022222222201
10101010121010101
100022200200P0001
11111111111111111
