11111111111111111
1p000000000000001
12121010101010101
10020002220200001
10101012101010101
10020202020200001
10101010101010101
10202022222200001
10101010101210101
10000000000200001
10101010101210101
10000022202200001
10101010101010101
100000000000P0001
11111111111111111
