11111111111111111111111111111111111
1p000000000000000000000000000000001
12121010101010101010101010101010101
10020002220200000000000000000000001
10101012101010101010101010101010101
10020202020200000000000000000000001
10101010101010101010101010101010101
10202022222200000000000000000000001
10101010101210101010101010101010101
10000000000200000000000000000000001
10101010101210101010101010101010101
10000022202200000000000200020202021
10101010101010101212121212121212121
100000000000P0000000000000020202021
11111111111111111111111111111111111
